#######################
#..........#..........#
#.###.####.#.####.###.#
#o###.####.#.####.###o#
#.....................#
#.###.#.#######.#.###.#
#.....#....#....#.....#
#####.#### # ####.#####
#   #.#    =    #.#   #
#####.# ### ### #.#####
#    .  # === #  .    #
#####.# ####### #.#####
#   #.#    %    #.#   #
#####.# ####### #.#####
#..........#..........#
#.###.####.#.####.###.#
#o#.#......\......#..o#
###.#.#.#######.#.#.###
#.....#....#....#.....#
#.########.#.########.#
#.....................#
#######################
